111111111111
10P0001E0C01
111111111111
