11111111111111111111111111111111111111111111111111111111111
1C01000000000000000000000000C000000000000000000000C11111111
10000111110011111111111111111111111111111110000000000000001
1P0011E0000000000000000000000000100000000000001111111111101
11111111111111111111111111111111111111111100011111111111111
10000000000111111000000011100000000000000000000000000000001
1C0000000000000000000000000000000000000000C1111111111111111
11111111111111111111111111111111111111111111111111111111111