111111111111
10P000E00C01
111111111111
